*    **** *   *  **** *        *****
*    *    *   *  *    *        *
*    ***  *   *  ***  *        *****
*    *     * *   *    *        *   *
**** ****   *    **** ****     *****
