*....****.*...*..****.*........*****
*....*....*...*..*....*........*...*
*....***..*...*..***..*........*...*
*....*.....*.*...*....*........*...*
****.****...*....****.****.....*****

*....****.*...*..****.*............*
*....*....*...*..*....*..........*.*
*....***..*...*..***..*........*...*
*....*.....*.*...*....*............*
****.****...*....****.****.........*

*....****.*...*..****.*.........***.
*....*....*...*..*....*........*...*
*....***..*...*..***..*..........*..
*....*.....*.*...*....*........*....
****.****...*....****.****.....*****

*....****.*...*..****.*........*****
*....*....*...*..*....*............*
*....***..*...*..***..*.........****
*....*.....*.*...*....*............*
****.****...*....****.****.....*****

*....****.*...*..****.*........*...*
*....*....*...*..*....*........*...*
*....***..*...*..***..*........*****
*....*.....*.*...*....*............*
****.****...*....****.****.........*