*    **** *   *  **** *            *
*    *    *   *  *    *          * *
*    ***  *   *  ***  *        *   *
*    *     * *   *    *            *
**** ****   *    **** ****         *

