*    **** *   *  **** *        *****
*    *    *   *  *    *        *   *
*    ***  *   *  ***  *        *****
*    *     * *   *    *            *
**** ****   *    **** ****     *****
