*    **** *   *  **** *        *****
*    *    *   *  *    *        *
*    ***  *   *  ***  *        *****
*    *     * *   *    *            *
**** ****   *    **** ****     *****
