*    **** *   *  **** *        *   *
*    *    *   *  *    *        *   *
*    ***  *   *  ***  *        *****
*    *     * *   *    *            *
**** ****   *    **** ****         * 