*    **** *   *  **** *         *** 
*    *    *   *  *    *        *   *
*    ***  *   *  ***  *          * 
*    *     * *   *    *        * 
**** ****   *    **** ****     *****