*    **** *   *  **** *     ***** *****
*    *    *   *  *    *         * *   *   
*    ***  *   *  ***  *     ***** *   *
*    *     * *   *    *     *     *   *  
**** ****   *    **** ****  ***** *****
