*    **** *   *  **** *        *****
*    *    *   *  *    *            *
*    ***  *   *  ***  *            *
*    *     * *   *    *            *
**** ****   *    **** ****         *
