*    **** *   *  **** *       * *****
*    *    *   *  *    *     * * *   *   
*    ***  *   *  ***  *       * *****
*    *     * *   *    *       * *   *  
**** ****   *    **** ****    * *****
