*    **** *   *  **** *       * *   *
*    *    *   *  *    *     * * *   *
*    ***  *   *  ***  *       * *****
*    *     * *   *    *       *     *  
**** ****   *    **** ****    *     *
