*    **** *   *  **** *       * *****
*    *    *   *  *    *     * * *   
*    ***  *   *  ***  *       * *****
*    *     * *   *    *       *     *  
**** ****   *    **** ****    * *****
