*    **** *   *  **** *       * *****
*    *    *   *  *    *     * * *   *
*    ***  *   *  ***  *       * *   *
*    *     * *   *    *       * *   *
**** ****   *    **** ****    * *****
