*    **** *   *  **** *       * *****
*    *    *   *  *    *     * *     *
*    ***  *   *  ***  *       *  ****
*    *     * *   *    *       *     *  
**** ****   *    **** ****    * *****
