*    **** *   *  **** *       * *****
*    *    *   *  *    *     * *     *
*    ***  *   *  ***  *       * *****
*    *     * *   *    *       * *     
**** ****   *    **** ****    * *****
