*    **** *   *  **** *        ***** 
*    *    *   *  *    *            *
*    ***  *   *  ***  *        *****  
*    *     * *   *    *        * 
**** ****   *    **** ****     *****