*    **** *   *  **** *     *****    *
*    *    *   *  *    *         *  * *   
*    ***  *   *  ***  *     *****    *
*    *     * *   *    *     *        *  
**** ****   *    **** ****  *****    *
