*    **** *   *  **** *        *****
*    *    *   *  *    *            *
*    ***  *   *  ***  *         ****
*    *     * *   *    *            *
**** ****   *    **** ****     *****