*    **** *   *  **** *       * *****
*    *    *   *  *    *     * *     *   
*    ***  *   *  ***  *       *     *
*    *     * *   *    *       *     *  
**** ****   *    **** ****    *     *
