*    **** *   *  **** *       * *****
*    *    *   *  *    *     * * *   *   
*    ***  *   *  ***  *       * *****
*    *     * *   *    *       *     *  
**** ****   *    **** ****    * *****
