*    **** *   *  **** *           *
*    *    *   *  *    *         * *
*    ***  *   *  ***  *           *
*    *     * *   *    *           *
**** ****   *    **** ****        *

