*    **** *   *  **** *       * *****
*    *    *   *  *    *     * * *   
*    ***  *   *  ***  *       * *****
*    *     * *   *    *       * *   *  
**** ****   *    **** ****    * *****
