*    **** *   *  **** *        *****
*    *    *   *  *    *        *   *
*    ***  *   *  ***  *        *****
*    *     * *   *    *        *   *
**** ****   *    **** ****     *****
