*    **** *   *  **** *       *   *
*    *    *   *  *    *     * * * *   
*    ***  *   *  ***  *       *   *   
*    *     * *   *    *       *   *   
**** ****   *    **** ****    *   *
